CCL_7860Renalcancer	CCL
CCL_A498Renalcancer	CCL
CCL_A549ATCCNonSmallCellLungcancer	CCL
CCL_ACHNRenalcancer	CCL
CCL_ALLSILTALL	CCL
CCL_BT549Breastcancer	CCL
CCL_CAKI1Renalcancer	CCL
CCL_CCRFCEMLeukemia	CCL
CCL_CLBGANeuroblastoma	CCL
CCL_COGN387Neuroblastoma	CCL
CCL_COLO205Coloncancer	CCL
CCL_DND41TALL	CCL
CCL_DU145Prostatecancer	CCL
CCL_E2ABALL	CCL
CCL_EKVXNonSmallCellLungcancer	CCL
CCL_HAL01BALL	CCL
CCL_HCC2998Coloncancer	CCL
CCL_HCT116Coloncancer	CCL
CCL_HCT15Coloncancer	CCL
CCL_HL60Leukemia	CCL
CCL_HOP62NonSmallCellLungcancer	CCL
CCL_HOP92NonSmallCellLungcancer	CCL
CCL_HPBALLTALL	CCL
CCL_Hs578TBreastcancer	CCL
CCL_HT29Coloncancer	CCL
CCL_IGROV1Ovariancancer	CCL
CCL_IMR32Neuroblastoma	CCL
CCL_JURKATTALL	CCL
CCL_K562Leukemia	CCL
CCL_KM12Coloncancer	CCL
CCL_LOUCYTALL	CCL
CCL_LOXIMVIMelanoma	CCL
CCL_M14Melanoma	CCL
CCL_MALME3MMelanoma	CCL
CCL_MCF7Breastcancer	CCL
CCL_MDAMB231Breastcancer	CCL
CCL_MDAMB435Melanoma	CCL
CCL_MDAMB468Breastcancer	CCL
CCL_MOLT16TALL	CCL
CCL_MOLT4Leukemia	CCL
CCL_N206Neuroblastoma	CCL
CCL_NALM16BALL	CCL
CCL_NALM6BALL	CCL
CCL_NB1Neuroblastoma	CCL
CCL_NCI/ADRRESNonSmallCellLungcancer	CCL
CCL_NCIH226NonSmallCellLungcancer	CCL
CCL_NCIH23NonSmallCellLungcancer	CCL
CCL_NCIH322MNonSmallCellLungcancer	CCL
CCL_NCIH460NonSmallCellLungcancer	CCL
CCL_NCIH522Ovariancancer	CCL
CCL_NGPNeuroblastoma	CCL
CCL_OVCAR3Ovariancancer	CCL
CCL_OVCAR4Ovariancancer	CCL
CCL_OVCAR5Ovariancancer	CCL
CCL_OVCAR8Ovariancancer	CCL
CCL_PC3Prostatecancer	CCL
CCL_PEERTALL	CCL
CCL_RajiBurkittsLymphoma	CCL
CCL_RCHACVBALL	CCL
CCL_REHBALL	CCL
CCL_RMPI8226Leukemia	CCL
CCL_RXF393Renalcancer	CCL
CCL_SEMBALL	CCL
CCL_SF268CNScancer	CCL
CCL_SF295CNScancer	CCL
CCL_SF539CNScancer	CCL
CCL_SHEPNeuroblastoma	CCL
CCL_SHSY5YNeuroblastoma	CCL
CCL_SKMEL28Melanoma	CCL
CCL_SKMEL2Melanoma	CCL
CCL_SKMEL5Melanoma	CCL
CCL_SKNASNeuroblastoma	CCL
CCL_SKNBE2cNeuroblastoma	CCL
CCL_SKNSHNeuroblastoma	CCL
CCL_SKOV3Ovariancancer	CCL
CCL_SN12CRenalcancer	CCL
CCL_SNB19CNScancer	CCL
CCL_SNB75CNScancer	CCL
CCL_SRLeukemia	CCL
CCL_SUPB15BALL	CCL
CCL_SW620Coloncancer	CCL
CCL_T47DBreastcancer	CCL
CCL_TALL1TALL	CCL
CCL_TK10Renalcancer	CCL
CCL_U251CNScancer	CCL
CCL_UACC257Melanoma	CCL
CCL_UACC62Melanoma	CCL
CCL_UO31Renalcancer	CCL
CL_H1	CL
CL_HEK293T	CL
CL_JY	CL
CL_NKL	CL
CL_YTS	CL
CT_AdiposeMicrovascularEndothelialCell	CT
CT_AdrenalCorticalCell	CT
CT_AdrenalFibroblasts	CT
CT_AdrenalMicrovascularEndothelialCell	CT
CT_Alveolarmacrophagedonor4	CT
CT_Alveolarmacrophagedonor7	CT
CT_AmnioticEpithelialCell	CT
CT_AmnioticMesenchymalStromalCell	CT
CT_AnulusPulposusCell	CT
CT_AorticEndothelialCell	CT
CT_AorticFibroblast	CT
CT_AorticSmoothMuscleCell	CT
CT_Astrocyte	CT
CT_Astrocytecerebellar	CT
CT_Astrocytehippocampal	CT
CT_Astrocytesbrainstemcel	CT
CT_Astrocytesmidbrain	CT
CT_Astrocytespinalcord	CT
CT_BladderMicrovascularEndothelialCell	CT
CT_BladderSmoothMuscleCell	CT
CT_BrainMicrovascularEndothelialCell	CT
CT_BrainVascularAdventitialFibroblasts	CT
CT_BrainVascularPericyte	CT
CT_BrainVascularSmoothMuscleCell	CT
CT_BronchialEpithelialCell	CT
CT_BronchialSmoothMuscleCell	CT
CT_CalvarialOsteoblast	CT
CT_CardiacFibroblast	CT
CT_CardiacFibroblastadult	CT
CT_CardiacFibroblastadultatrial	CT
CT_CardiacFibroblastadultventrical	CT
CT_CardiacFibroblastfetalatrial	CT
CT_CardiacMicrovascularEndothelialCell	CT
CT_CardiacMyocyte	CT
CT_CardiacMyocyteadult	CT
CT_CBCD34lin	CT
CT_CD14Monocytes	CT
CT_CD19Bcells	CT
CT_CD3Tcells	CT
CT_CD56NKcells	CT
CT_Chondrocytearticular	CT
CT_ChorionicMesenchymalStromalCell	CT
CT_ChoroidPlexusEpithelialCell	CT
CT_ChoroidPlexusFibroblast	CT
CT_ColonicEpithelialCelltotalRNA	CT
CT_ColonicMicrovascularEndothelialCell	CT
CT_ColonicSmoothMuscleCell	CT
CT_ConjunctivalFibroblast	CT
CT_CornealEpithelialCell	CT
CT_CoronaryArteryEndothelialcell	CT
CT_DermalFibroblastadult	CT
CT_DermalFibroblastfetal	CT
CT_DermalFibroblastfetalMitomycinCtreated	CT
CT_DermalFibroblastneonate	CT
CT_DermalLymphaticEndothelialCell	CT
CT_DermalMicrovascularEndothelialCell	CT
CT_EndometrialMicorvascularEndothelialCell	CT
CT_EpidermalKeratinocyteadult	CT
CT_EpidermalKeratinocytefetal	CT
CT_EpidermalKeratinocyteneonate	CT
CT_EpidermalMelanocyteadult	CT
CT_EpidermalMelanocytedark	CT
CT_EpidermalMelanocytelight	CT
CT_EpidermalMelanocytemedium	CT
CT_EsophagealEpithelialCell	CT
CT_EsophagealFibroblasts	CT
CT_EsophagealSmoothMuscleCell	CT
CT_GallbladderFibroblast	CT
CT_GastricSmoothMuscleCell	CT
CT_GingivalFibroblast	CT
CT_HairDermalPapillaCell	CT
CT_HairFollicularInnerRootSheathCell	CT
CT_HairFollicularKeratinocyte	CT
CT_HairFollicularOuterRootSheathCell	CT
CT_HairGerminalMatrixCell	CT
CT_HepaticSinusoidalEndothelialCell	CT
CT_HepaticStellateCell	CT
CT_Hepatocyte	CT
CT_Immaturemonocytederiveddendriticcells	CT
CT_IntestinalFibroblasts	CT
CT_IntestinalSmoothMuscleCell	CT
CT_IrisPigmentEpithelialCell	CT
CT_Keratocyte	CT
CT_LensEpithelialCell	CT
CT_LymphaticEndothelialCell	CT
CT_LymphaticFibroblast	CT
CT_MammaryEndothelialCell	CT
CT_MammaryEpithelialCell	CT
CT_MammaryFibroblast	CT
CT_Maturemonocytederiveddendriticcells	CT
CT_MeningealCell	CT
CT_MesenchymalStemCelladipose	CT
CT_MesenchymalStemCellbonemarrow	CT
CT_MesenchymalStemCellhepatic	CT
CT_Monocytes	CT
CT_MyometrialMicrovascularEndothelialCell	CT
CT_MyometrialSmoothMuscleCell	CT
CT_Neuron	CT
CT_NonPigmentCiliaryEpithelialCell	CT
CT_NucleusPulposusCell	CT
CT_OcularChoroidFibroblast	CT
CT_OligodendrocytePrecursorCell	CT
CT_OralKeratinocyte	CT
CT_Osteoblastfemural	CT
CT_OvarianFibroblast	CT
CT_OvarianMicrovascularEndothelialCell	CT
CT_OvarianSurfaceEpithelialCell	CT
CT_PancreaticStallateCell	CT
CT_pericardialfibroblast	CT
CT_PerineurialCell	CT
CT_PeriodontalLigamentFibroblast	CT
CT_Preadipocytesubcutaneous	CT
CT_Preadipocytevisceral	CT
CT_ProstateEpithelialCell	CT
CT_ProstateFibroblast	CT
CT_ProstateMicrovascularEndothelialCell	CT
CT_PulmonaryAlveolarEpithelialCell	CT
CT_PulmonaryArteryEndothelialCell	CT
CT_PulmonaryArteryFibroblast	CT
CT_PulmonaryArterySmoothMuscleCell	CT
CT_PulmonaryFibroblast	CT
CT_pulmonaryFibroblastAdult	CT
CT_PulmonaryMesenchymalStelCell	CT
CT_PulmonaryMicrovascularEndothelialCell	CT
CT_RectalSmoothMuscleCell	CT
CT_RenalCorticalEpithelialCell	CT
CT_RenalEpithelialCell	CT
CT_RenalGlomerularEndothelialCell	CT
CT_RenalMesangialCell	CT
CT_RenalProximalTubularEpithelialCell	CT
CT_RetinalAstrocyte	CT
CT_RetinalPigmentEpithelialCell	CT
CT_SchwannCell	CT
CT_SeminalVesicleEpithelialCell	CT
CT_SeminalVesicleFibroblast	CT
CT_SeminalVesicleMicrovascularEndothelialCell	CT
CT_SkeletalMuscleCell	CT
CT_SkeletalMuscleMyoblast	CT
CT_SkeletalMuscleSatelliteCell	CT
CT_SmallAirwayEpithelialCell	CT
CT_SplenicEndothelialcell	CT
CT_SplenicFibroblast	CT
CT_Synoviocyte	CT
CT_ThymusFibroblasts	CT
CT_ThyroidFibroblasts	CT
CT_TonsilEndothelialCell	CT
CT_TonsilEpithelialCell	CT
CT_TonsilFibroblaststotalRNA	CT
CT_TrabecularMeshworkCell	CT
CT_TrachealEpithelialCell	CT
CT_TrachealSmoothMuscleCell	CT
CT_UmbilicalArteryEndothelialCell	CT
CT_UmbilicalArterySmoothMuscleCell	CT
CT_UmbilicalMesenchymalStemCell	CT
CT_UmbilicalVeinEndothelialCell	CT
CT_UmbilicalVeinSmoothMuscleCell	CT
CT_UrothelialCell	CT
CT_VertebralMesenchymalStemCell	CT
CT_VillousMesenchymalFibroblast	CT
CT_VillousTrophoblast	CT
T_adiposetissue	T
T_adrenaltissue	T
T_bladdertissue	T
T_Braincerebellumtissue	T
T_Brainfrontalcortextissue	T
T_Brainoccipitalcortextissue	T
T_Brainparietalcortextissue	T
T_Brainstemtissue	T
T_Brainstriatumtissue	T
T_braintissue	T
T_breasttissue	T
T_cervixtissue	T
T_colontissue	T
T_distalcolontissue	T
T_duodenumtissue	T
T_esophagustissue	T
T_fallopiantubetissue	T
T_FetalBraintissue	T
T_hearttissue	T
T_ileumtissue	T
T_jejunumtissue	T
T_kidneytissue	T
T_leftatruimtissue	T
T_leftventricletissue	T
T_livertissue	T
T_lungtissue	T
T_lymphnodetissue	T
T_ovarytissue	T
T_pancreastissue	T
T_pericardiumtissue	T
T_placentatissue	T
T_prostatetissue	T
T_proximalcolontissue	T
T_rightatriumtissue	T
T_rightventricletissue	T
T_skeletalmuscletissue	T
T_smallintestinetissue	T
T_spleentissue	T
T_stomachtissue	T
T_testicletissue	T
T_thymustissue	T
T_thyroidtissue	T
T_tracheatissue	T
T_uterustissue	T
T_venacavatissue	T
